{"layers":[
        {
         "data":[41, 42, 42, 42, 42, 42, 42, 42, 42, 42, 43, 44, 45, 46, 47, 218,
            245, 234, 235, 235, 236, 235, 236, 235, 236, 235, 236, 235, 236, 235, 237, 238,
            245, 306, 242, 241, 242, 241, 242, 241, 242, 241, 242, 241, 242, 242, 259, 238,
            245, 306, 262, 261, 262, 261, 262, 261, 262, 261, 262, 261, 262, 262, 259, 238,
            245, 306, 242, 241, 242, 241, 242, 241, 242, 241, 242, 241, 242, 242, 259, 238,
            245, 306, 262, 261, 262, 261, 262, 261, 262, 261, 262, 261, 262, 262, 259, 238,
            245, 306, 242, 241, 242, 241, 242, 241, 242, 241, 242, 241, 242, 242, 259, 238,
            245, 306, 262, 261, 262, 261, 262, 261, 262, 261, 262, 261, 262, 262, 259, 238,
            245, 306, 242, 241, 242, 241, 242, 241, 242, 241, 242, 241, 242, 242, 259, 238,
            245, 306, 262, 261, 262, 261, 262, 261, 262, 261, 262, 261, 262, 262, 259, 238,
            245, 306, 242, 241, 242, 241, 242, 241, 242, 241, 242, 241, 242, 242, 259, 238,
            245, 306, 262, 261, 262, 261, 262, 261, 262, 261, 262, 261, 262, 262, 259, 238,
            245, 306, 242, 241, 242, 241, 242, 241, 242, 241, 242, 241, 242, 242, 259, 238,
            245, 306, 262, 261, 262, 261, 262, 261, 262, 261, 262, 261, 262, 262, 259, 238,
            245, 246, 247, 248, 248, 248, 248, 248, 248, 248, 248, 248, 248, 248, 249, 250,
            265, 266, 267, 268, 268, 268, 268, 268, 268, 268, 268, 268, 268, 268, 269, 270],
         "height":16,
         "width":16,
        }],
 "tileheight":32,
 "tilewidth":32
}